##########
##########
MB     HD#
#D #######
#H      BM
####### D#
MB      H#
#D #######
#H      BM
####### D#
MB      H#
#D #######
#H      BM
####### D#
MB      H#
#D #######
#H      BM
####### D#
MB      H#
#D  @   D#
##########
